-1
 #######
#.B..A.#
#@aba.b#
#@@c.C.#
#...@.@#
#######
