 ######
##...A#
#@aaa.#
#@@a.#
#.@..#
######
